##########################
#                        #
#   ####     ####     ## #
#   ####     ####     ## #
#   ####     ####     ## #
#                        #
#          #######       #
#          #######       #
#          #######       #
#                        #
#   ####     ####     ## #
#   ####     ####     ## #
#   ####     ####     ## #
#                        #
#                        #
#                        #
#   ####     ####     ## #
#   ####     ####     ## #
#   ####     ####     ## #
#                        #
##########################
