##########################
# H                      #
#                        #
#                        #
#                        #
#              M         #
#                        #
#                        #
#                        #
#                        #
#                        #
#                        #
#   M                    #
#                        #
#                        #
#                        #
#               M        #
#                        #
#                        #
#                        #
##########################
